mapa1
2 2
1 1 1 1 1 1 0 0 0 0
1 0 0 0 0 1 0 0 0 0
1 0 0 2 0 1 1 1 1 1
1 0 0 0 0 0 0 0 0 1
1 0 0 0 0 2 2 0 0 1
1 0 0 0 0 2 0 1 3 1
1 1 1 0 1 0 0 1 3 1
1 0 0 0 0 0 0 1 3 1
1 0 0 0 0 0 0 1 3 1
1 1 1 1 1 1 1 1 1 1

mapa2
5 4
0 0 0 0 1 1 1 1 1 0
0 0 0 0 1 0 0 0 1 0
1 1 1 1 1 0 1 0 1 1
1 0 0 1 0 2 0 0 0 1
1 0 0 0 2 0 0 1 0 1
1 0 3 3 0 1 0 0 0 1
1 1 1 0 0 1 1 1 1 1
0 0 1 0 0 1 0 0 0 0
0 0 1 1 1 0 0 0 0 0

mapa3
6 3
0 1 1 1 1 1 0 0 0 0
1 1 0 0 3 1 0 0 0 0
1 0 2 1 3 1 0 0 0 0
1 0 0 0 0 1 1 0 0 0
1 1 0 1 0 0 1 0 0 0
0 1 2 0 0 0 1 0 0 0
0 1 0 0 0 1 1 0 0 0
0 1 1 1 1 1 0 0 0 0
0 0 0 0 0 0 0 0 0 0
0 0 0 0 0 0 0 0 0 0

mapa4
3 3
1 1 1 1 1 0 0 0 0 0
1 0 0 0 1 0 0 0 0 0
1 3 1 2 1 1 0 0 0 0
1 0 0 0 0 1 0 0 0 0
1 3 0 2 0 1 0 0 0 0
1 1 1 0 0 1 0 0 0 0
0 0 1 1 1 1 0 0 0 0
